99999999199999999
99999991219999999
99999912321999999
99999123432199999
99991234543219999
99912345654321999
99123456765432199
91234567876543219
11111111187654321
91234567876543219
99123456765432199
99912345654321999
99991234543219999
99999123432199999
99999912321999999
99999991219999999
99999999199999999
|
goal / energy
8 444
|
position
8 8
|
6 2
7 14
8 3
0 11
3 2
9 8
2 9
16 4